R 	1000 800 

NO ./textures/brick2.xpm   
SO ./textures/wall.xpm 
WE ./textures/brick.xpm
EA ./textures/wall2.xpm

S    ./textures/3.xpm   


F       63,    145,     11 
C       45,    140,    190
    
        1111111111111111  1111111
        1020001100110001  1000001
        1011022001110001111001201
        1021011100000200102001111
111111111011002001110002000000001
100000020011000001110011111001111
10210111101111000210000002110121  
11110020000011002000110000020101      
1000001111020001111111000E000001      
1011001  1011101   1200021110011     
1201001  1002001   1100110000011     
1111201  1200001   1100000111021       
1111111  1111111   1111111111111

